{
  "aquarium": {

    "MAPA_SURVIVE": "01",
    "blockers": 0,
	"initial_position_crab_1": {"x":2, "y":3, "direction": "horizontal"},
    "initial_position_crab_2": {"x":14, "y":11, "direction": "horizontal"},
    "grid": [
      [1,6,6,6,6,6,1,1,1,1,1,1,1,1,1,1,1],
      [1,3,0,0,0,0,0,0,0,0,0,0,0,0,0,3,1],
      [1,0,1,0,1,0,1,0,1,0,1,0,1,1,1,0,1],
      [1,0,0,0,0,0,0,0,0,0,0,0,0,0,0,0,1],
      [1,0,1,0,1,0,1,0,1,0,1,0,1,1,1,0,1],
      [1,0,0,0,0,0,1,0,1,0,1,0,0,0,0,0,1],
      [1,0,1,0,1,0,0,0,0,0,0,0,1,1,1,0,1],
      [1,0,0,0,0,0,6,6,6,6,6,0,0,0,0,0,1],
      [1,0,1,1,1,0,0,0,0,0,0,0,1,0,1,0,1],
      [1,0,0,0,0,0,1,0,1,0,1,0,0,0,0,0,1],
      [1,0,1,1,1,0,1,0,1,0,1,0,1,0,1,0,1],
      [1,0,0,0,0,0,0,0,0,0,0,0,0,0,0,0,1],
	  [1,0,1,1,1,0,1,0,1,0,1,0,1,0,1,0,1],
      [1,3,0,0,0,0,0,0,0,0,0,0,0,0,0,3,1],
      [1,1,1,1,1,1,1,1,1,1,1,6,6,6,6,6,1]
    ]
  },

  "baseball_field": {

    "MAPA_SURVIVE": "01",
    "blockers": 0,
    "grid": [
      [8,8,1,1,1,1,1,1,1,1,1,1,1,1,1,8,8],
      [8,3,0,0,0,0,0,0,4,0,0,0,0,0,0,3,8],
      [1,0,0,0,0,6,6,1,1,1,6,6,0,0,0,0,1],
      [1,0,0,0,0,6,0,0,0,0,0,6,0,0,0,0,1],
      [1,0,0,0,0,0,0,1,1,1,0,0,0,0,0,0,1],
      [1,0,0,0,0,0,0,0,0,0,0,0,0,0,0,0,1],
      [1,0,6,6,0,1,0,2,2,2,0,1,0,6,6,0,1],
      [1,0,4,1,0,1,0,2,2,2,0,1,0,1,4,0,1],
      [1,0,6,6,0,1,0,2,2,2,0,1,0,6,6,0,1],
      [1,0,0,0,0,0,0,0,0,0,0,0,0,0,0,0,1],
      [1,0,0,0,0,0,0,1,1,1,0,0,0,0,0,0,1],
      [1,0,0,0,0,6,0,0,0,0,0,6,0,0,0,0,1],
	  [1,0,0,0,0,6,6,1,1,1,6,6,0,0,0,0,1],
      [8,3,0,0,0,0,0,0,4,0,0,0,0,0,0,3,8],
      [8,8,1,1,1,1,1,1,1,1,1,1,1,1,1,8,8]
    ]
  },

  "bathroom": {

    "MAPA_SURVIVE": "01",
    "blockers": 0,
    "grid": [
      [8,8,1,1,1,1,6,6,6,6,6,1,1,1,1,8,8],
      [8,3,0,0,0,0,0,0,0,0,0,0,0,0,0,3,8],
      [1,0,6,0,1,1,0,1,0,1,0,1,1,0,6,0,1],
      [1,0,6,0,0,0,0,0,0,0,0,0,0,0,6,0,1],
      [1,0,6,0,1,1,0,1,0,1,0,1,1,0,6,0,1],
      [1,0,6,0,0,0,0,0,0,0,0,0,0,0,6,0,1],
      [1,0,6,0,1,1,0,2,2,2,0,1,1,0,6,0,1],
      [1,0,0,0,0,0,0,2,2,2,0,0,0,0,0,0,1],
      [1,0,6,0,1,1,0,2,2,2,0,1,1,0,6,0,1],
      [1,0,6,0,0,0,0,0,0,0,0,0,0,0,6,0,1],
      [1,0,6,0,1,1,0,1,0,1,0,1,1,0,6,0,1],
      [1,0,6,0,0,0,0,0,0,0,0,0,0,0,6,0,1],
	  [1,0,6,0,1,1,0,1,0,1,0,1,1,0,6,0,1],
      [8,3,0,0,0,0,0,0,0,0,0,0,0,0,0,3,8],
      [8,8,1,1,1,1,6,6,6,6,6,1,1,1,1,8,8]
    ]
  },

  "castle": {
    "MAPA_SURVIVE": "01",
    "blockers": 0,
    "grid": [
      [8,8,1,6,6,6,1,1,1,1,1,6,6,6,1,8,8],
      [8,3,0,0,0,0,0,0,6,0,0,0,0,0,0,3,8],
      [1,0,1,1,0,1,1,0,0,0,1,1,0,1,1,0,1],
      [1,0,0,0,0,0,0,0,6,0,0,0,0,0,0,0,1],
      [1,0,1,1,0,1,1,0,0,0,1,1,0,1,1,0,1],
      [1,0,0,0,0,0,0,0,6,0,0,0,0,0,0,0,1],
      [6,0,1,1,0,1,1,0,6,0,1,1,0,1,1,0,6],
      [6,0,0,0,0,0,0,0,6,0,0,0,0,0,0,0,6],
      [6,0,1,1,0,1,1,0,6,0,1,1,0,1,1,0,6],
      [1,0,0,0,0,0,0,0,6,0,0,0,0,0,0,0,1],
      [1,0,1,1,0,1,1,0,0,0,1,1,0,1,1,0,1],
      [1,0,0,0,0,0,0,0,6,0,0,0,0,0,0,0,1],
	  [1,0,1,1,0,1,1,0,0,0,1,1,0,1,1,0,1],
      [8,3,0,0,0,0,0,0,6,0,0,0,0,0,0,3,8],
      [8,8,1,6,6,6,1,1,1,1,1,6,6,6,1,8,8]
    ]
  },

  "doll_house": {
    "MAPA_SURVIVE": "01",
    "blockers": 0,
	"train_route": [[3,3],[13,3],[13,11],[3,11]],
    "grid": [
      [1,1,6,6,6,6,6,6,6,6,6,6,6,6,6,1,1],
      [1,3,0,0,0,0,0,0,0,0,0,0,0,0,0,3,1],
      [6,0,1,0,1,0,1,0,1,0,1,0,1,0,1,0,6],
      [6,0,0,4,4,4,4,4,4,4,4,4,4,4,0,0,6],
      [1,0,1,4,1,0,1,0,1,0,1,0,1,4,1,0,1],
      [1,0,1,4,1,0,1,0,0,0,1,0,1,4,1,0,1],
      [6,0,0,4,0,0,0,0,8,0,0,0,0,4,0,0,6],
      [6,0,1,4,6,6,0,8,8,8,0,6,6,4,1,0,6],
      [6,0,0,4,0,0,0,0,8,0,0,0,0,4,0,0,6],
      [1,0,1,4,1,0,1,0,0,0,1,0,1,4,1,0,1],
      [1,0,1,4,1,0,1,0,1,0,1,0,1,4,1,0,1],
      [6,0,0,4,4,4,4,4,4,4,4,4,4,4,0,0,6],
	  [6,0,1,0,1,0,1,0,1,0,1,0,1,0,1,0,6],
      [1,3,0,0,0,0,0,0,0,0,0,0,0,0,0,3,1],
      [1,1,6,6,6,6,6,6,6,6,6,6,6,6,6,1,1]
    ]
  },

  "farm": {
    "MAPA_SURVIVE": "01",
    "blockers": 0,
    "grid": [
      [8,8,1,1,1,1,1,6,6,6,1,1,1,1,1,8,8],
      [8,3,0,0,0,0,0,0,0,0,0,0,0,0,0,3,8],
      [1,0,1,0,1,0,1,0,1,0,1,0,1,0,1,0,1],
      [1,0,1,0,1,0,1,0,1,0,1,0,1,0,1,0,1],
      [6,0,0,0,0,0,0,0,1,0,0,0,0,0,0,0,6],
      [1,0,1,0,1,0,1,0,0,0,1,0,1,0,1,0,1],
      [1,0,0,0,0,0,0,0,8,0,0,0,0,0,0,0,1],
      [1,0,6,6,6,6,0,8,8,8,0,6,6,6,6,0,1],
      [1,0,0,0,0,0,0,0,8,0,0,0,0,0,0,0,1],
      [1,0,1,0,1,0,1,0,0,0,1,0,1,0,1,0,1],
      [6,0,0,0,0,0,0,0,1,0,0,0,0,0,0,0,6],
      [1,0,1,0,1,0,1,0,1,0,1,0,1,0,1,0,1],
	  [1,0,1,0,1,0,1,0,1,0,1,0,1,0,1,0,1],
      [8,3,0,0,0,0,0,0,0,0,0,0,0,0,0,3,8],
      [8,8,1,1,1,1,1,6,6,6,1,1,1,1,1,8,8]
    ]
  },

  "garden": {
    "MAPA_SURVIVE": "01",
    "blockers": 0,
    "grid": [
      [8,8,1,1,1,1,6,1,6,1,6,1,1,1,1,8,8],
      [8,3,0,0,0,0,0,0,0,0,0,0,0,0,0,3,8],
      [1,0,1,1,0,1,0,1,0,1,0,1,0,1,1,0,1],
      [6,0,0,0,0,0,0,0,0,0,0,0,0,0,0,0,6],
      [1,0,1,0,1,1,0,1,0,1,0,1,1,0,1,0,1],
      [6,0,0,0,0,0,0,0,0,0,0,0,0,0,0,0,6],
      [1,0,1,0,1,1,0,2,2,2,0,1,1,0,1,0,1],
      [6,0,0,0,0,0,0,2,2,2,0,0,0,0,0,0,6],
      [1,0,1,0,1,1,0,2,2,2,0,1,1,0,1,0,1],
      [6,0,0,0,0,0,0,0,0,0,0,0,0,0,0,0,6],
      [1,0,1,0,1,1,0,1,0,1,0,1,1,0,1,0,1],
      [6,0,0,0,0,0,0,0,0,0,0,0,0,0,0,0,6],
	  [1,0,1,1,0,1,0,1,0,1,0,1,0,1,1,0,1],
      [8,3,0,0,0,0,0,0,0,0,0,0,0,0,0,3,8],
      [8,8,1,1,1,1,6,1,6,1,6,1,1,1,1,8,8]
    ]
  },

  "picnic": {
    "MAPA_SURVIVE": "01",
    "blockers": 0,
    "grid": [
      [8,8,6,6,6,6,6,6,6,6,6,6,6,6,6,8,8],
      [8,3,0,0,0,0,0,0,0,0,0,0,0,0,0,3,8],
      [6,0,1,0,1,0,1,0,1,0,1,0,1,0,1,0,6],
      [6,0,1,0,6,0,1,0,1,0,1,0,6,0,1,0,6],
      [6,0,0,0,0,0,0,0,1,0,0,0,0,0,0,0,6],
      [6,0,1,1,0,1,1,0,0,0,1,1,0,1,1,0,6],
      [6,0,0,0,0,0,0,0,8,0,0,0,0,0,0,0,6],
      [6,0,1,1,0,1,0,8,8,8,0,1,0,1,1,0,6],
      [6,0,0,0,0,0,0,0,8,0,0,0,0,0,0,0,6],
      [6,0,1,1,0,1,1,0,0,0,1,1,0,1,1,0,6],
      [6,0,0,0,0,0,0,0,1,0,0,0,0,0,0,0,6],
      [6,0,1,0,6,0,1,0,1,0,1,0,6,0,1,0,6],
	  [6,0,1,0,1,0,1,0,1,0,1,0,1,0,1,0,6],
      [8,3,0,0,0,0,0,0,0,0,0,0,0,0,0,3,8],
      [8,8,6,6,6,6,6,6,6,6,6,6,6,6,6,8,8]
    ]
  },

  "polar_region": {
    "MAPA_SURVIVE": "01",
    "blockers": 0,
    "grid": [
      [1,1,1,6,6,6,6,6,6,6,6,6,6,6,1,1,1],
      [1,3,0,0,0,0,0,0,0,0,0,0,0,0,0,3,1],
      [6,0,1,1,0,1,0,1,0,1,0,1,0,1,1,0,6],
      [6,0,0,0,0,0,4,4,4,4,4,0,0,0,0,0,6],
      [6,0,1,1,0,1,0,1,0,1,0,1,0,1,1,0,6],
      [1,0,0,0,0,0,0,0,0,0,0,0,0,0,0,0,1],
      [1,0,1,1,4,1,0,2,2,2,0,1,4,1,1,0,1],
      [1,0,0,0,4,0,0,2,2,2,0,0,4,0,0,0,1],
      [1,0,1,1,4,1,0,2,2,2,0,1,4,1,1,0,1],
      [1,0,0,0,0,0,0,0,0,0,0,0,0,0,0,0,1],
      [6,0,1,1,0,1,0,1,0,1,0,1,0,1,1,0,6],
      [6,0,0,0,0,0,4,4,4,4,4,0,0,0,0,0,6],
	  [6,0,1,1,0,1,0,1,0,1,0,1,0,1,1,0,6],
      [1,3,0,0,0,0,0,0,0,0,0,0,0,0,0,3,1],
      [1,1,1,6,6,6,6,6,6,6,6,6,6,6,1,1,1]
    ]
  }
}