{

  "aquarium": [

    { "MAPA_ARCADE": "01",
      "blockers": 90,
      "initial_position_crab_1": {"x":2, "y":2, "direction": "horizontal"},
      "initial_position_crab_2": {"x":12, "y":10, "direction": "horizontal"},
      "grid": [
        [3,0,0,0,0,0,0,0,0,0,0,0,0,0,3],
        [0,1,1,1,0,1,1,1,1,1,0,1,1,1,0],
        [0,1,7,7,7,7,7,7,7,7,7,7,7,1,0],
        [0,1,0,1,1,0,1,1,1,0,1,1,0,1,0],
        [0,0,0,0,0,0,0,0,0,0,0,0,0,0,0],
        [1,1,0,1,1,0,2,2,2,0,1,1,0,1,1],
        [0,0,0,0,0,0,2,2,2,0,0,0,0,0,0],
        [1,1,0,1,1,0,2,2,2,0,1,1,0,1,1],
        [0,0,0,0,0,0,0,0,0,0,0,0,0,0,0],
        [0,1,0,1,1,0,1,1,1,0,1,1,0,1,0],
        [0,1,7,7,7,7,7,7,7,7,7,7,7,1,0],
        [0,1,1,1,0,1,1,1,1,1,0,1,1,1,0],
        [3,0,0,0,0,0,0,0,0,0,0,0,0,0,3]
      ]
    },
    { "MAPA_ARCADE": "02",
      "blockers": 90,
      "initial_position_crab_1": {"x":5, "y":6, "direction": "horizontal"},
      "initial_position_crab_2": {"x":9, "y":6, "direction": "horizontal"},
      "grid": [
        [3,0,0,1,0,1,1,0,1,1,0,1,0,0,3],
        [0,1,0,0,0,0,0,0,0,0,0,0,0,1,0],
        [0,1,1,1,0,1,1,0,1,1,0,1,1,1,0],
        [0,0,0,0,0,0,0,0,0,0,0,0,0,0,0],
        [1,0,1,0,1,0,1,1,1,0,1,0,1,0,1],
        [1,1,1,0,1,0,2,2,2,0,1,0,1,1,1],
        [7,7,7,7,7,7,2,2,2,7,7,7,7,7,7],
        [1,1,1,0,1,0,2,2,2,0,1,0,1,1,1],
        [1,0,1,0,1,0,1,1,1,0,1,0,1,0,1],
        [0,0,0,0,0,0,0,0,0,0,0,0,0,0,0],
        [0,1,1,1,0,1,1,0,1,1,0,1,1,1,0],
        [0,1,0,0,0,0,0,0,0,0,0,0,0,1,0],
        [3,0,0,1,0,1,1,0,1,1,0,1,0,0,3]
      ]
    },
	{ "MAPA_ARCADE": "03",
      "blockers": 90,
      "initial_position_crab_1": {"x":2, "y":1, "direction": "vertical"},
      "initial_position_crab_2": {"x":12, "y":11, "direction": "vertical"},
      "grid": [
        [3,0,1,0,0,0,0,1,0,0,0,0,1,0,3],
        [0,1,7,1,0,1,1,0,1,1,0,1,7,1,0],
        [0,0,7,0,0,0,0,0,0,0,0,0,7,0,0],
        [0,1,7,1,1,0,1,0,1,0,1,1,7,1,0],
        [0,0,7,0,0,0,0,0,0,0,0,0,7,0,0],
        [1,1,7,1,1,0,2,2,2,0,1,1,7,1,1],
        [0,0,7,0,0,0,2,2,2,0,0,0,7,0,0],
        [1,1,7,1,1,0,2,2,2,0,1,1,7,1,1],
        [0,0,7,0,0,0,0,0,0,0,0,0,7,0,0],
        [0,1,7,1,1,0,1,0,1,0,1,1,7,1,0],
        [0,0,7,0,0,0,0,0,0,0,0,0,7,0,0],
        [0,1,7,1,0,1,1,0,1,1,0,1,7,1,0],
        [3,0,1,0,0,0,0,1,0,0,0,0,1,0,3]
      ]
    }
  ],

  "baseball_field": [

    { "MAPA_ARCADE": "01",
      "blockers": 90,
      "grid": [
        [3,0,0,0,1,0,0,0,0,0,1,0,0,0,3],
        [0,1,0,1,1,0,1,0,1,0,1,1,0,1,0],
        [0,0,0,7,7,7,0,0,0,7,7,7,0,0,0],
        [0,1,1,7,1,7,1,1,1,7,1,7,1,1,0],
        [0,4,1,7,1,7,0,0,0,7,1,7,1,4,0],
        [0,0,1,0,1,0,2,2,2,0,1,0,1,0,0],
        [1,0,0,0,0,0,2,2,2,0,0,0,0,0,1],
        [0,0,1,0,1,0,2,2,2,0,1,0,1,0,0],
        [0,4,1,7,1,7,0,0,0,7,1,7,1,4,0],
        [0,1,1,7,1,7,1,1,1,7,1,7,1,1,0],
        [0,0,0,7,7,7,0,0,0,7,7,7,0,0,0],
        [0,1,0,1,1,0,1,0,1,0,1,1,0,1,0],
        [3,0,0,0,1,0,0,0,0,0,1,0,0,0,3]
      ]
    },
    { "MAPA_ARCADE": "02",
      "blockers": 90,
      "grid": [
        [3,0,0,0,0,0,0,4,0,0,0,0,0,0,3],
        [0,1,0,1,1,1,1,1,1,1,1,1,0,1,0],
        [0,1,0,0,1,7,7,7,0,0,1,0,0,1,0],
        [0,1,1,0,0,7,1,1,1,7,0,0,1,1,0],
        [0,0,0,0,1,0,0,7,7,7,1,0,0,0,0],
        [0,1,1,7,7,7,2,2,2,0,1,0,1,1,0],
        [0,4,1,7,1,7,2,2,2,7,1,7,1,4,0],
        [0,1,1,0,1,0,2,2,2,7,7,7,1,1,0],
        [0,0,0,0,1,7,7,7,0,0,1,0,0,0,0],
        [0,1,1,0,0,7,1,1,1,7,0,0,1,1,0],
        [0,1,0,0,1,0,0,7,7,7,1,0,0,1,0],
        [0,1,0,1,1,1,1,1,1,1,1,1,0,1,0],
        [3,0,0,0,0,0,0,4,0,0,0,0,0,0,3]
      ]
    },
	{ "MAPA_ARCADE": "03",
      "blockers": 90,
      "grid": [
        [3,0,0,0,0,1,0,1,0,1,0,0,0,0,3],
        [0,1,1,0,1,1,0,0,0,1,1,0,1,1,0],
        [0,4,1,7,1,7,0,1,0,7,1,7,1,4,0],
        [1,0,1,7,7,7,1,0,1,7,7,7,1,0,1],
        [0,0,0,0,1,0,0,0,0,0,1,0,0,0,0],
        [1,1,0,1,0,0,2,2,2,0,0,1,0,1,1],
        [0,0,0,0,0,1,2,2,2,1,0,0,0,0,0],
        [1,1,0,1,0,0,2,2,2,0,0,1,0,1,1],
        [0,0,0,0,1,0,0,0,0,0,1,0,0,0,0],
        [1,0,1,7,7,7,1,0,1,7,7,7,1,0,1],
        [0,4,1,7,1,7,0,1,0,7,1,7,1,4,0],
        [0,1,1,0,1,1,0,0,0,1,1,0,1,1,0],
        [3,0,0,0,0,1,0,1,0,1,0,0,0,0,3]
      ]
    }
  ],

  "bathroom": [

    { "MAPA_ARCADE": "01",
      "one_hallway": true,
      "blockers": 90,
      "grid": [
        [3,0,0,1,0,0,0,0,0,0,0,1,0,0,3],
        [0,1,0,1,1,0,1,0,1,0,1,1,0,1,0],
        [0,0,0,0,0,0,1,7,1,0,0,0,0,0,0],
        [1,1,0,1,1,0,1,7,1,0,1,1,0,1,1],
        [0,0,0,0,0,0,0,7,0,0,0,0,0,0,0],
        [0,1,1,0,1,0,2,2,2,0,1,0,1,1,0],
        [0,0,7,7,7,7,2,2,2,7,7,7,7,0,0],
        [0,1,1,0,1,0,2,2,2,0,1,0,1,1,0],
        [0,0,0,0,0,0,0,7,0,0,0,0,0,0,0],
        [1,1,0,1,1,0,1,7,1,0,1,1,0,1,1],
        [0,0,0,0,0,0,1,7,1,0,0,0,0,0,0],
        [0,1,0,1,1,0,1,0,1,0,1,1,0,1,0],
        [3,0,0,1,0,0,0,0,0,0,0,1,0,0,3]
      ]
    },
    { "MAPA_ARCADE": "02",
      "blockers": 90,
      "one_hallway": false,
      "grid": [
        [3,0,0,0,0,1,0,0,0,1,0,0,0,0,3],
        [0,1,1,1,0,1,0,1,0,1,0,1,1,1,0],
        [0,0,0,0,0,0,7,1,7,0,0,0,0,0,0],
        [0,1,0,1,0,1,7,1,7,1,0,1,0,1,0],
        [0,1,0,1,0,1,7,0,7,1,0,1,0,1,0],
        [0,0,7,7,7,7,2,2,2,7,7,7,7,0,0],
        [1,0,1,0,1,0,2,2,2,0,1,0,1,0,1],
        [0,0,7,7,7,7,2,2,2,7,7,7,7,0,0],
        [0,1,0,1,0,1,7,0,7,1,0,1,0,1,0],
        [0,1,0,1,0,1,7,1,7,1,0,1,0,1,0],
        [0,0,0,0,0,0,7,1,7,0,0,0,0,0,0],
        [0,1,1,1,0,1,0,1,0,1,0,1,1,1,0],
        [3,0,0,0,0,1,0,0,0,1,0,0,0,0,3]
      ]
    },
	{ "MAPA_ARCADE": "03",
      "blockers": 90,
      "one_hallway": true,
      "grid": [
        [3,0,0,0,0,0,1,0,1,0,0,0,0,0,3],
        [0,1,0,1,1,0,0,0,0,0,1,1,0,1,0],
        [0,1,0,0,0,0,1,7,1,0,0,0,0,1,0],
        [1,1,0,1,1,0,1,7,1,0,1,1,0,1,1],
        [0,0,0,0,0,0,0,7,0,0,0,0,0,0,0],
        [0,1,0,1,1,0,2,2,2,0,1,1,0,1,0],
        [0,0,7,7,7,7,2,2,2,7,7,7,7,0,0],
        [0,1,0,1,1,0,2,2,2,0,1,1,0,1,0],
        [0,0,0,0,0,0,0,7,0,0,0,0,0,0,0],
        [1,1,0,1,1,0,1,7,1,0,1,1,0,1,1],
        [0,1,0,0,0,0,1,7,1,0,0,0,0,1,0],
        [0,1,0,1,1,0,0,0,0,0,1,1,0,1,0],
        [3,0,0,0,0,0,1,0,1,0,0,0,0,0,3]
      ]
    }
  ],

  "doll_house": [

    { "MAPA_ARCADE": "01",
      "blockers": 90,
      "train_route": [[4,2],[10,2],[10,3],[12,3],[12,9],[10,9],[10,10],[4,10],[4,9],[2,9],[2,3],[4,3]],
      "grid": [
        [3,0,0,0,0,0,0,1,0,0,0,0,0,0,3],
        [0,1,1,1,0,1,1,1,1,1,0,1,1,1,0],
        [0,0,0,1,4,4,4,4,4,4,4,1,0,0,0],
        [0,1,4,4,4,1,1,1,1,1,4,4,4,1,0],
        [0,1,4,1,1,0,0,0,0,0,1,1,4,1,0],
        [0,1,4,0,0,0,2,2,2,0,0,0,4,1,0],
        [1,0,4,1,1,0,2,2,2,0,1,1,4,0,1],
        [0,1,4,0,0,0,2,2,2,0,0,0,4,1,0],
        [0,1,4,1,1,0,0,0,0,0,1,1,4,1,0],
        [0,1,4,4,4,1,1,1,1,1,4,4,4,1,0],
        [0,0,0,1,4,4,4,4,4,4,4,1,0,0,0],
        [0,1,1,1,0,1,1,1,1,1,0,1,1,1,0],
        [3,0,0,0,0,0,0,1,0,0,0,0,0,0,3]
      ]
    },
    { "MAPA_ARCADE": "02",
      "blockers": 90,
      "train_route": [[2,2],[12,2],[12,10],[2,10]],
      "grid": [
        [3,0,0,0,0,0,0,1,0,0,0,0,0,0,3],
        [0,1,1,1,0,1,1,1,1,1,0,1,1,1,0],
        [0,1,4,4,4,4,4,4,4,4,4,4,4,1,0],
        [0,1,4,1,1,1,1,0,1,1,1,1,4,1,0],
        [0,0,4,0,0,0,0,0,0,0,0,0,4,0,0],
        [0,1,4,1,1,0,2,2,2,0,1,1,4,1,0],
        [1,1,4,0,1,0,2,2,2,0,1,0,4,1,1],
        [0,1,4,1,1,0,2,2,2,0,1,1,4,1,0],
        [0,0,4,0,0,0,0,0,0,0,0,0,4,0,0],
        [0,1,4,1,1,1,1,0,1,1,1,1,4,1,0],
        [0,1,4,4,4,4,4,4,4,4,4,4,4,1,0],
        [0,1,1,1,0,1,1,1,1,1,0,1,1,1,0],
        [3,0,0,0,0,0,0,1,0,0,0,0,0,0,3]
      ]
    },
    { "MAPA_ARCADE": "03",
      "blockers": 90,
      "train_route": [[4,1],[11,1],[11,11],[2,11],[2,3],[13,3],[13,9],[4,9]],
      "grid": [
        [3,0,0,0,0,1,1,1,0,1,1,1,0,0,3],
        [0,1,0,1,4,4,4,4,4,4,4,4,0,1,0],
        [0,1,1,1,4,1,1,1,1,1,1,4,1,1,0],
        [0,0,4,4,4,4,4,4,4,4,4,4,4,4,0],
        [1,1,4,1,4,1,1,1,1,0,1,4,1,4,1],
        [0,1,4,1,4,0,2,2,2,0,1,4,1,4,1],
        [0,1,4,1,4,1,2,2,2,0,0,4,0,4,0],
        [0,0,4,0,4,1,2,2,2,0,1,4,1,4,1],
        [1,1,4,1,4,1,0,1,1,0,1,4,1,4,1],
        [0,1,4,1,4,4,4,4,4,4,4,4,4,4,0],
        [0,1,4,1,0,1,1,0,1,1,1,4,1,1,0],
        [0,1,4,4,4,4,4,4,4,4,4,4,0,1,0],
        [3,0,0,1,1,1,0,1,1,0,1,1,0,0,3]
      ]
    }
  ],

  "polar_region": [

    { "MAPA_ARCADE": "01",
      "blockers": 90,
      "grid": [
        [3,0,0,1,1,0,0,0,0,0,1,1,0,0,3],
        [0,1,0,0,0,0,1,0,1,0,0,0,0,1,0],
        [0,1,1,1,1,0,0,0,0,0,1,1,1,1,0],
        [0,0,0,4,0,0,1,1,1,0,0,4,0,0,0],
        [1,0,1,4,1,0,0,0,0,0,1,4,1,0,1],
        [1,0,1,4,1,0,2,2,2,0,1,4,1,0,1],
        [0,0,0,4,0,0,2,2,2,0,0,4,0,0,0],
        [1,0,1,4,1,0,2,2,2,0,1,4,1,0,1],
        [1,0,1,4,1,0,0,0,0,0,1,4,1,0,1],
        [0,0,0,4,0,0,1,1,1,0,0,4,0,0,0],
        [0,1,1,1,1,0,0,0,0,0,1,1,1,1,0],
        [0,1,0,0,0,0,1,0,1,0,0,0,0,1,0],
        [3,0,0,1,1,0,0,0,0,0,1,1,0,0,3]
      ]
    },
	{ "MAPA_ARCADE": "02",
      "blockers": 90,
      "grid": [
        [3,0,0,0,0,0,0,1,0,0,0,0,0,0,3],
        [0,1,1,0,1,1,1,1,1,1,1,0,1,1,0],
        [0,1,0,0,4,4,4,4,4,4,4,0,0,1,0],
        [0,0,1,0,1,1,1,0,1,1,1,0,1,0,0],
        [1,0,0,0,0,0,0,0,0,0,0,0,0,0,1],
        [1,0,1,0,1,0,2,2,2,0,1,0,1,0,1],
        [0,0,0,1,1,0,2,2,2,0,1,1,0,0,0],
        [1,0,1,0,0,0,2,2,2,0,0,0,1,0,1],
        [1,0,0,0,1,0,0,0,0,0,1,0,0,0,1],
        [0,0,1,0,1,1,1,0,1,1,1,0,1,0,0],
        [0,1,0,0,4,4,4,4,4,4,4,0,0,1,0],
        [0,1,1,0,1,1,1,1,1,1,1,0,1,1,0],
        [3,0,0,0,0,0,0,1,0,0,0,0,0,0,3]
      ]
    },
	{ "MAPA_ARCADE": "03",
      "blockers": 90,
      "grid": [
        [3,7,7,0,0,0,0,0,0,0,0,0,7,7,3],
        [1,7,1,0,1,0,1,0,1,0,1,0,1,7,1],
        [0,0,0,0,0,4,4,4,4,4,0,0,0,0,0],
        [1,0,1,0,1,0,1,0,1,0,1,0,1,0,1],
        [0,0,0,0,0,0,0,0,0,0,0,0,0,0,0],
        [1,0,1,4,1,0,2,2,2,0,1,4,1,0,1],
        [0,0,0,4,0,0,2,2,2,0,0,4,0,0,0],
        [1,0,1,4,1,0,2,2,2,0,1,4,1,0,1],
        [0,0,0,0,0,0,0,0,0,0,0,0,0,0,0],
        [1,0,1,0,1,0,1,0,1,0,1,0,1,0,1],
        [0,0,0,0,0,4,4,4,4,4,0,0,0,0,0],
        [1,7,1,0,1,0,1,0,1,0,1,0,1,7,1],
        [3,7,7,0,0,0,0,0,0,0,0,0,7,7,3]
      ]
    }
  ]

}